total_local_loads,total_embed_loads,sd_local_plays,sd_embed_plays,hd_local_plays,hd_embed_plays,sd_local_finishes,sd_embed_finishes,hd_local_finishes,hd_embed_finishes,comments,downloads,likes,total_loads,total_local_plays,total_embed_plays,total_plays,total_local_finishes,total_embed_finishes,total_finishes,range_start,range_end,date
566,7,6,0,8,0,0,0,1,0,0,0,0,573,14,0,14,1,0,1,2011-12-26,2011-12-31,Woche vom 26.12.2011
765,3,8,1,11,0,1,0,3,0,0,0,0,768,19,1,20,4,0,4,2011-12-19,2011-12-25,Woche vom 19.12.2011
656,5,38,0,27,0,1,0,1,0,0,0,0,661,65,0,65,2,0,2,2011-12-12,2011-12-18,Woche vom 12.12.2011
825,6,27,4,51,0,2,0,5,0,0,0,0,831,78,4,82,7,0,7,2011-12-05,2011-12-11,Woche vom 05.12.2011
808,17,33,2,55,0,5,0,4,0,0,0,0,825,88,2,90,9,0,9,2011-11-28,2011-12-04,Woche vom 28.11.2011
792,23,50,1,58,0,3,0,8,0,0,0,0,815,108,1,109,11,0,11,2011-11-21,2011-11-27,Woche vom 21.11.2011
1051,25,35,3,96,0,5,0,14,0,0,1,0,1076,131,3,134,19,0,19,2011-11-14,2011-11-20,Woche vom 14.11.2011
1064,10,58,1,223,0,12,0,29,0,0,0,0,1074,281,1,282,41,0,41,2011-11-07,2011-11-13,Woche vom 07.11.2011
666,38,59,3,36,0,7,0,3,0,0,0,0,704,95,3,98,10,0,10,2011-10-31,2011-11-06,Woche vom 31.10.2011
596,14,32,0,15,0,1,0,3,0,0,0,0,610,47,0,47,4,0,4,2011-10-24,2011-10-30,Woche vom 24.10.2011
668,14,42,2,23,0,4,0,3,0,0,0,0,682,65,2,67,7,0,7,2011-10-17,2011-10-23,Woche vom 17.10.2011
617,26,30,2,17,0,5,0,0,0,0,0,0,643,47,2,49,5,0,5,2011-10-10,2011-10-16,Woche vom 10.10.2011
705,26,40,1,20,0,7,0,2,0,0,0,0,731,60,1,61,9,0,9,2011-10-03,2011-10-09,Woche vom 03.10.2011
1022,42,23,0,11,0,1,0,1,0,0,0,0,1064,34,0,34,2,0,2,2011-09-26,2011-10-02,Woche vom 26.09.2011
1124,37,41,1,14,0,5,0,6,0,0,0,7,1161,55,1,56,11,0,11,2011-09-19,2011-09-25,Woche vom 19.09.2011
996,36,26,1,16,0,5,0,0,0,0,0,0,1032,42,1,43,5,0,5,2011-09-12,2011-09-18,Woche vom 12.09.2011
772,22,41,1,11,0,11,0,0,0,0,0,0,794,52,1,53,11,0,11,2011-09-05,2011-09-11,Woche vom 05.09.2011
723,30,56,1,14,0,11,0,2,0,0,2,0,753,70,1,71,13,0,13,2011-08-29,2011-09-04,Woche vom 29.08.2011
903,18,42,2,9,0,4,0,5,0,0,0,0,921,51,2,53,9,0,9,2011-08-22,2011-08-28,Woche vom 22.08.2011
956,33,38,1,17,0,5,0,3,0,0,0,0,989,55,1,56,8,0,8,2011-08-15,2011-08-21,Woche vom 15.08.2011
882,38,42,0,14,0,5,0,3,0,0,0,0,920,56,0,56,8,0,8,2011-08-08,2011-08-14,Woche vom 08.08.2011
872,41,35,3,12,0,6,1,3,0,0,1,0,913,47,3,50,9,1,10,2011-08-01,2011-08-07,Woche vom 01.08.2011
804,59,48,1,11,0,7,0,3,0,0,0,0,863,59,1,60,10,0,10,2011-07-25,2011-07-31,Woche vom 25.07.2011
519,113,37,0,14,0,9,0,5,0,0,0,0,632,51,0,51,14,0,14,2011-07-18,2011-07-24,Woche vom 18.07.2011
481,77,21,4,23,0,1,0,7,0,0,0,0,558,44,4,48,8,0,8,2011-07-11,2011-07-17,Woche vom 11.07.2011
449,56,18,1,11,0,1,0,1,0,0,0,0,505,29,1,30,2,0,2,2011-07-04,2011-07-10,Woche vom 04.07.2011
424,29,15,0,7,0,6,0,2,0,0,0,0,453,22,0,22,8,0,8,2011-06-27,2011-07-03,Woche vom 27.06.2011
289,41,26,4,10,0,10,0,2,0,0,0,0,330,36,4,40,12,0,12,2011-06-20,2011-06-26,Woche vom 20.06.2011
366,42,19,4,10,0,1,0,1,0,0,0,0,408,29,4,33,2,0,2,2011-06-13,2011-06-19,Woche vom 13.06.2011
295,34,13,1,13,0,3,0,1,0,0,0,0,329,26,1,27,4,0,4,2011-06-06,2011-06-12,Woche vom 06.06.2011
147,14,13,3,2,0,1,0,0,0,0,0,0,161,15,3,18,1,0,1,2011-05-30,2011-06-05,Woche vom 30.05.2011
270,20,27,1,7,0,4,0,1,0,0,1,0,290,34,1,35,5,0,5,2011-05-23,2011-05-29,Woche vom 23.05.2011
115,24,18,3,5,0,1,0,0,0,0,0,0,139,23,3,26,1,0,1,2011-05-16,2011-05-22,Woche vom 16.05.2011
236,20,23,3,5,0,3,0,0,0,0,0,0,256,28,3,31,3,0,3,2011-05-09,2011-05-15,Woche vom 09.05.2011
232,42,34,4,4,0,8,2,0,0,0,0,0,274,38,4,42,8,2,10,2011-05-02,2011-05-08,Woche vom 02.05.2011
389,35,22,9,10,0,2,0,2,0,0,0,0,424,32,9,41,4,0,4,2011-04-25,2011-05-01,Woche vom 25.04.2011
398,38,25,0,3,0,2,0,2,0,0,2,0,436,28,0,28,4,0,4,2011-04-18,2011-04-24,Woche vom 18.04.2011
363,40,9,1,3,0,1,0,0,0,0,3,0,403,12,1,13,1,0,1,2011-04-11,2011-04-17,Woche vom 11.04.2011
578,34,13,6,7,0,1,1,0,0,0,0,0,612,20,6,26,1,1,2,2011-04-04,2011-04-10,Woche vom 04.04.2011
527,35,6,5,0,0,1,0,0,0,0,0,1,562,6,5,11,1,0,1,2011-03-28,2011-04-03,Woche vom 28.03.2011
503,42,26,10,3,0,4,0,1,0,0,2,0,545,29,10,39,5,0,5,2011-03-21,2011-03-27,Woche vom 21.03.2011
896,33,15,1,4,0,1,0,0,0,0,0,0,929,19,1,20,1,0,1,2011-03-14,2011-03-20,Woche vom 14.03.2011
586,37,16,0,9,0,1,0,1,0,0,0,0,623,25,0,25,2,0,2,2011-03-07,2011-03-13,Woche vom 07.03.2011
1008,26,27,0,24,0,1,0,6,0,0,0,0,1034,51,0,51,7,0,7,2011-02-28,2011-03-06,Woche vom 28.02.2011
785,107,107,5,48,0,3,0,8,0,0,0,0,892,155,5,160,11,0,11,2011-02-21,2011-02-27,Woche vom 21.02.2011
816,32,42,2,56,0,3,0,14,0,0,0,0,848,98,2,100,17,0,17,2011-02-14,2011-02-20,Woche vom 14.02.2011
782,16,42,2,44,0,9,0,6,0,0,0,0,798,86,2,88,15,0,15,2011-02-07,2011-02-13,Woche vom 07.02.2011
686,32,13,3,42,0,1,1,4,0,0,0,0,718,55,3,58,5,1,6,2011-01-31,2011-02-06,Woche vom 31.01.2011
795,177,14,8,44,0,4,2,7,0,0,0,0,972,58,8,66,11,2,13,2011-01-24,2011-01-30,Woche vom 24.01.2011
685,26,19,2,28,0,2,0,3,0,0,0,0,711,47,2,49,5,0,5,2011-01-17,2011-01-23,Woche vom 17.01.2011
950,29,28,4,34,0,5,0,9,0,0,0,0,979,62,4,66,14,0,14,2011-01-10,2011-01-16,Woche vom 10.01.2011
724,66,16,6,39,0,6,2,7,0,0,0,0,790,55,6,61,13,2,15,2011-01-03,2011-01-09,Woche vom 03.01.2011
286,14,6,2,15,0,4,0,4,0,0,0,0,300,21,2,23,8,0,8,2011-01-01,2011-01-02,Woche vom 27.12.2010