total_local_loads,total_embed_loads,sd_local_plays,sd_embed_plays,hd_local_plays,hd_embed_plays,sd_local_finishes,sd_embed_finishes,hd_local_finishes,hd_embed_finishes,comments,downloads,likes,total_loads,total_local_plays,total_embed_plays,total_plays,total_local_finishes,total_embed_finishes,total_finishes,range_start,range_end,date
34,6,0,0,2,0,0,0,0,0,0,0,0,40,2,0,2,0,0,0,2013-12-30,2013-12-31,Woche vom 30.12.2013
155,46,17,4,5,0,0,2,1,0,0,1,0,201,22,4,26,1,2,3,2013-12-23,2013-12-29,Woche vom 23.12.2013
103,40,19,6,8,0,2,0,1,0,0,0,0,143,27,6,33,3,0,3,2013-12-16,2013-12-22,Woche vom 16.12.2013
104,41,19,2,11,1,1,0,1,0,0,0,0,145,30,3,33,2,0,2,2013-12-09,2013-12-15,Woche vom 09.12.2013
148,35,27,11,7,0,4,1,1,0,0,1,0,183,34,11,45,5,1,6,2013-12-02,2013-12-08,Woche vom 02.12.2013
195,53,30,8,5,0,3,0,2,0,0,3,0,248,35,8,43,5,0,5,2013-11-25,2013-12-01,Woche vom 25.11.2013
178,104,30,9,8,0,2,0,1,0,0,3,0,282,38,9,47,3,0,3,2013-11-18,2013-11-24,Woche vom 18.11.2013
159,34,19,6,6,0,1,0,0,0,0,1,0,193,25,6,31,1,0,1,2013-11-11,2013-11-17,Woche vom 11.11.2013
124,30,19,2,7,0,4,0,0,0,0,0,0,154,26,2,28,4,0,4,2013-11-04,2013-11-10,Woche vom 04.11.2013
118,24,9,4,6,1,1,0,1,0,0,1,0,142,15,5,20,2,0,2,2013-10-28,2013-11-03,Woche vom 28.10.2013
228,46,27,5,0,0,4,0,0,0,0,3,0,274,27,5,32,4,0,4,2013-10-21,2013-10-27,Woche vom 21.10.2013
1263,24,54,2,1,0,3,0,1,0,0,0,0,1287,55,2,57,4,0,4,2013-10-14,2013-10-20,Woche vom 14.10.2013
1284,18,25,1,0,0,3,0,0,0,0,0,0,1302,25,1,26,3,0,3,2013-10-07,2013-10-13,Woche vom 07.10.2013
1087,24,19,0,1,0,1,0,0,0,0,0,0,1111,20,0,20,1,0,1,2013-09-30,2013-10-06,Woche vom 30.09.2013
1450,26,20,6,0,0,1,1,0,0,0,0,0,1476,20,6,26,1,1,2,2013-09-23,2013-09-29,Woche vom 23.09.2013
872,25,25,3,1,0,4,1,1,0,0,0,0,897,26,3,29,5,1,6,2013-09-16,2013-09-22,Woche vom 16.09.2013
905,45,14,2,1,0,1,0,0,0,0,1,0,950,15,2,17,1,0,1,2013-09-09,2013-09-15,Woche vom 09.09.2013
929,19,13,4,0,0,1,0,0,0,0,0,0,948,13,4,17,1,0,1,2013-09-02,2013-09-08,Woche vom 02.09.2013
986,57,11,2,1,0,1,0,0,0,0,0,0,1043,12,2,14,1,0,1,2013-08-26,2013-09-01,Woche vom 26.08.2013
1068,23,9,1,0,0,1,0,0,0,0,0,0,1091,9,1,10,1,0,1,2013-08-19,2013-08-25,Woche vom 19.08.2013
1013,30,10,1,0,0,1,0,0,0,0,0,0,1043,10,1,11,1,0,1,2013-08-12,2013-08-18,Woche vom 12.08.2013
895,44,12,6,1,0,1,0,1,0,0,0,0,939,13,6,19,2,0,2,2013-08-05,2013-08-11,Woche vom 05.08.2013
992,61,18,2,0,0,1,1,0,0,0,0,0,1053,18,2,20,1,1,2,2013-07-29,2013-08-04,Woche vom 29.07.2013
1022,36,15,0,0,0,1,0,0,0,0,1,0,1058,15,0,15,1,0,1,2013-07-22,2013-07-28,Woche vom 22.07.2013
861,66,14,2,1,0,1,0,1,0,0,0,0,927,15,2,17,2,0,2,2013-07-15,2013-07-21,Woche vom 15.07.2013
800,54,18,4,2,0,2,1,1,0,0,0,1,854,20,4,24,3,1,4,2013-07-08,2013-07-14,Woche vom 08.07.2013
647,51,14,6,0,0,1,2,0,0,0,0,0,698,14,6,20,1,2,3,2013-07-01,2013-07-07,Woche vom 01.07.2013
751,53,16,2,0,0,4,0,0,0,0,0,0,804,16,2,18,4,0,4,2013-06-24,2013-06-30,Woche vom 24.06.2013
744,53,14,3,0,0,4,1,0,0,0,1,0,797,14,3,17,4,1,5,2013-06-17,2013-06-23,Woche vom 17.06.2013
1101,8,29,2,4,0,0,0,1,0,0,2,0,1109,33,2,35,1,0,1,2013-06-10,2013-06-16,Woche vom 10.06.2013
588,6,18,2,0,0,2,0,0,0,0,0,0,594,18,2,20,2,0,2,2013-06-03,2013-06-09,Woche vom 03.06.2013
701,2,16,1,1,0,2,1,0,0,0,0,0,703,17,1,18,2,1,3,2013-05-27,2013-06-02,Woche vom 27.05.2013
687,5,21,2,2,0,3,0,1,0,0,1,0,692,23,2,25,4,0,4,2013-05-20,2013-05-26,Woche vom 20.05.2013
665,7,20,2,0,0,0,1,0,0,0,1,0,672,20,2,22,0,1,1,2013-05-13,2013-05-19,Woche vom 13.05.2013
778,11,24,5,2,0,1,1,0,0,0,0,0,789,26,5,31,1,1,2,2013-05-06,2013-05-12,Woche vom 06.05.2013
741,12,32,4,0,0,2,0,0,0,0,2,0,753,32,4,36,2,0,2,2013-04-29,2013-05-05,Woche vom 29.04.2013
856,7,24,2,0,0,3,1,0,0,0,1,0,863,24,2,26,3,1,4,2013-04-22,2013-04-28,Woche vom 22.04.2013
859,4,45,1,3,0,3,0,0,0,0,1,0,863,48,1,49,3,0,3,2013-04-15,2013-04-21,Woche vom 15.04.2013
971,7,25,1,2,0,4,0,0,0,0,0,0,978,27,1,28,4,0,4,2013-04-08,2013-04-14,Woche vom 08.04.2013
1120,7,24,1,4,0,1,0,1,0,0,1,0,1127,28,1,29,2,0,2,2013-04-01,2013-04-07,Woche vom 01.04.2013
1110,10,23,0,0,0,2,0,0,0,0,2,0,1120,23,0,23,2,0,2,2013-03-25,2013-03-31,Woche vom 25.03.2013
1183,2,23,0,0,0,0,0,0,0,0,0,0,1185,23,0,23,0,0,0,2013-03-18,2013-03-24,Woche vom 18.03.2013
876,21,30,5,1,0,1,1,0,0,0,0,0,897,31,5,36,1,1,2,2013-03-11,2013-03-17,Woche vom 11.03.2013
1035,12,29,1,3,0,6,0,0,0,0,1,0,1047,32,1,33,6,0,6,2013-03-04,2013-03-10,Woche vom 04.03.2013
1049,12,24,2,1,0,2,0,0,0,0,0,0,1061,25,2,27,2,0,2,2013-02-25,2013-03-03,Woche vom 25.02.2013
1380,5,24,1,1,0,4,0,0,0,0,1,0,1385,25,1,26,4,0,4,2013-02-18,2013-02-24,Woche vom 18.02.2013
907,13,31,2,1,0,2,0,0,0,0,4,0,920,32,2,34,2,0,2,2013-02-11,2013-02-17,Woche vom 11.02.2013
868,10,21,1,0,0,0,0,0,0,0,0,0,878,21,1,22,0,0,0,2013-02-04,2013-02-10,Woche vom 04.02.2013
897,12,30,1,1,0,2,0,0,0,0,0,0,909,31,1,32,2,0,2,2013-01-28,2013-02-03,Woche vom 28.01.2013
1060,17,20,3,1,0,7,0,0,0,0,1,0,1077,21,3,24,7,0,7,2013-01-21,2013-01-27,Woche vom 21.01.2013
976,11,32,1,1,0,7,0,0,0,0,0,0,987,33,1,34,7,0,7,2013-01-14,2013-01-20,Woche vom 14.01.2013
1002,15,22,1,0,0,4,1,0,0,0,2,0,1017,22,1,23,4,1,5,2013-01-07,2013-01-13,Woche vom 07.01.2013
721,10,12,0,0,0,4,0,0,0,0,1,0,731,12,0,12,4,0,4,2013-01-01,2013-01-06,Woche vom 31.12.2012